################
#s##....#.#.##.#
#..#......##.#.#
#.#..##.###.#.##
#.....#..##.##.#
#..#.....#..#..#
#..#.#.#....##.#
#.###..#...#...#
#.....##.##.#..#
#.....#..#.....#
#......#....#.e#
################
